########  ######
# >    ####    #
#             ~#
#      ####  ~~#
########  ######
